Zip Code,Total Population,Median Age,Total Males,Total Females,Total Households,Average Household Size
90291,28341,37.6,14757,13584,14261,1.95
90065,45527,36.1,22873,22654,14476,3.12
90211,8434,40.6,3849,4585,3706,2.28
90011,103892,26.2,52794,51098,22168,4.67
90001,57110,26.6,28468,28642,12971,4.4
93544,1259,52.4,689,570,569,2.2
91351,32362,33.9,16086,16276,10036,3.22
90061,26872,28.4,13049,13823,6892,3.85
93550,74929,27.5,36414,38515,20864,3.58
90008,32327,39.7,14477,17850,13841,2.33
