Zip Code,Total Population,Median Age,Total Males,Total Females,Total Households,Average Household Size
90020,38967,34.6,19381,19586,16514,2.35
90266,35135,40.9,17605,17530,14038,2.5
91406,51558,33.6,25956,25602,17042,3.02
90008,32327,39.7,14477,17850,13841,2.33
91504,24939,38.6,12006,12933,9180,2.69
90221,53704,26.7,26346,27358,11630,4.57
90240,25876,35.5,12501,13375,7632,3.36
90026,67869,34,34515,33354,24956,2.68
93535,72046,28.3,34879,37167,20672,3.44
91606,44958,34.3,22376,22582,14903,3
